              111111111
        22222222
333333333333333333
444444444444444444444
5555555555555555555555555
