  NO 	north
   		SO 			south
		 WE    		west
		 	 EA   		east

 		 F  		 250,100,123
 	 		C  	  225,30,0

     111111111
  111110000001111111
  10010111100000000111
   1001001000N001000001
  1111111111111111111111111111111
