SO ./texture_png/bluewall.png

NO ./texture_png/testno.png

EA ./texture_png/graywall.png

WE ./texture_png/redbrick.png

C 23,0,10

F 0,0,0

1111111111111           111111     1111111
1000000000000111111111111N0001      1000001
1011100000000000000000000000011111111000001
1001000000000000000000001000000000000000001
111111110011000001100000010111111111111111
1000000001100000111011111101110111111111111
11110111111111011100000010000000000000000001111111111
11110111111111011101010010001111111000000000000000001111111111
1100000011010101110000001000011    11110000000000000000000000011111111
10000000000000000000000100011      100000000000000000000000000000000001
10000000000000001101000010001      11111111110000000000011111111111111
110000011101010111110101100011               1100111110011
11110111 1110101 101110000001                 100111110011
11111111 1111111 111111111111                 100111110011
                                              100111110011
                                              100000000011
                                              111100001111
                                              111111111111